T T T T T ,1o1,1T T T T T T 
T T , , , , o , , , , , T T 
T h , , , , o , , , h , , T 
T , , , h d o d h d , , , T 
T , , d d d o d d d , h , T 
T , h d d d o d d d , , , T 
T , d d H H o H H d h , , T 
T , d d o o F o o d d , , T 
T , h d H o o o H d d h , T 
T , d d d H o H d d d , , T 
T , T d d d o d d d h , , T 
T , , d h d o h d d , h , T 
T h , , , , o , , h , T T T 
T , , h , , o , , , T T T T 
T , , , , , o , , , , T T T 
T T T T T ,2o2,2T T T T T T 
