, , , , , ,1d1,1~ ~ ~ ~ , , 
, , , , , , d , , , ~ ~ ~ ~ 
T T T T T T o T T T T d ~ ~ 
T T , , , , o , , , , d d T 
T h , , , , o , , , h d , T 
T , , , , d o d , d d , , T 
T , , d h d o d h d , h , T 
T , h d d d o d d d , , , T 
T , d d d H o H d d h , , T 
T , d d H o o o H d d , , T 
T , h d o o F o o d d h , T 
T , d d H H o H H d d , , T 
T , T d d d o d d d h , , T 
T , , d d d o h d d , h , T 
T h , , h , o , d h , T T T 
T , , h , , o , , , T T T T 
T , , , , , o , , , , T T T 
T T T T T T o2T T T T T T T 
