T T T T T T , , T T T T T T T T 
T T T T T T ,1,1T T T T T T T T 
T T T T T T , , T T T T T T T T 
T , T T T , , T T T T , T T T T 
T T T T T , , T T T T T T T , T 
T T T T , , T T T , T T T T T T 
T T T T , , T T T T T , , , T T 
T T T , , T T T T T , ~ ~ , T T 
T T T , , T T T T T , ~ ~ , T T 
T T T T , , T T T T T , ~ , T T 
T T T , , , , T T T T , ~ T T T 
T T , , , d2, , T T T T ~ ~ T T 
T , , , , , , , , T T T ~ ~ ~ ~ 
~ ~ ~ ~ ~ ~ ~ ~ ~ ~ ~ ~ ~ ~ ~ ~ 
~ ~ ~ ~ ~ ~ ~ ~ ~ ~ ~ ~ ~ ~ ~ ~ 
~ ~ ~ ~ ~ ~ ~ ~ ~ ~ ~ ~ T T T T 
T T T T T T T T T T T T T T T T 
T T T T T T T T T T T T T T T T 
T T T T T T T T T T T T T T T T 
