X X X _1X X X 
X X X _ X X X 
X X X _ X X X 
X X _ _ _ X X 
X X _ _ _ X X 
X X _ _ _ X X 
X X _ _ _ X X 
X X _ _ _ X X 
X X _ _ _ X X 
X X X _ X X X 
X X X X X X X 
